άτιμῶσοιι - άτιμάσαι.

Alpa. οιόρω. οιὶρῶ. ε’ρῶ cum compositu.
βούλομαι - βουλεύομαι.

δεκάζειν -ν δικάζειν.

διεωσάμην - διεσωσάμην.

δόξαν, δεδόχόοιι - δεῖξαι, δεδεῑχόαι.
ἕξάιτνσεν - ἑζότιισεν.

ἐπέτειος - ἐπαίτιος.

ἕως - τόως.

ἥδιον - όδιον.

ἠκκλησίαζον - ἐξεκλησίαζον.

κολάψοοι , ἐκκολάψαι - κόψαι , ἐκκόψαι.
κομόσοιι - κοσμῆσαι.

ληχθῆναι - λεχθῆναι, δειχθῆναι.

όμόσαι - ὁμολογῆσαι.

πάτριος - ποιτρῶιος.

πόλις - πολιτεία.

πράττω - προστάττω, τάττω.

πράγμοο - πρόσταγμα.

ρ’ρῖον - ῥᾴδιον.

σφίσιν - φησιν.

τό παόάν-τί μοιόών. ’

τότόν - τάόν.

φαόνειν -- φέρειν ei composita.

φόεόρω. περιφόεόρομαι - φέρω. περιφέρομαι.

φλαῦρον - φαῦλον.
quibus similia quilibet ex apparatu critico Platonis, Demosthe·
nie et eliorum plena manu adiicere poterit.

Inspiciamus ex hie nonnulle paullo diligentius. ΑΙΡΩ 111
'eeeue et fortune ferebat aui αἴρω 1111 αἱρῶ scribebatur aut in
ε’ρῶ corrumpebatur, utini λόγος ἕρεῑ pro αἱρεῖ. Hinc sexcen-
ties inter ee permiscentur αἴρεσθαι, αἱρεῖσθαι, άρασόοιι, άρεῖσόοιι,
αἰρόμενος, ἐρόμενος ei sim. in quibus omnibus quae videtur

 

